
NO ./textures/mand_text/north.xpm    
SO ./textures/mand_text/south.xpm
WE ./textures/mand_text/south.xpm  
EA ./textures/mand_text/east.xpm

F 255,255,255
C 204,255,64
SC 50

111111111111111111111111
100000000000000000000001
100000000000000000000001
100000000000000000000001
100000000N00000000000001
100000000000000000000001
100000000000000000000001
111111111111111111111111