NO ./textures/mand_text/eagle.xpm    
SO ./textures/mand_text/eagle.xpm
WE ./textures/mand_text/eagle.xpm   
EA ./textures/mand_text/eagle.xpm

F 127, 127, 127
C 135, 206, 250

1111111111111111111111111111
1X00000100100110000000000001
1111111111111111111111111111
