NO ./textures/mand_text/eagle.xpm    
SO ./textures/mand_text/eagle.xpm
WE ./textures/mand_text/eagle.xpm   
EA ./textures/mand_text/eagle.xpm

F 127, 127, 0
C 135, $$$, 100


1111111111111111111111111111
1E00000100100110000000000001
1111111111111111111111111111
