NO                              ./textures/eagle.xpm    
SO          ./textures/eagle.xpm
WE  ./textures/eagle.xpm   
EA   ./textures/eagle.xpm

F 127, 127, 0
C 135, docientos, 100


1111111111111111111111111111
1E00000100100110000000000001
1111111111111111111 11111111
