NO ./textures/eagle.xpm    
SO ./textures/eagle.xpm
WE ./textures/eagle.xpm   
EA ./textures/eagle.xpm

F 127, 127, 127
C 135, 206, 250

1111111111111111111111111111
1000000100100110000000000001
1E11111111111111111111111111
