

   

      NO       ./textures/eagle.xpm
SO	./textures/eagle.xpm



EA ./textures/eagle.xpm



F 30,240,200

	    	WE   			 ./textures/eagle.xpm
C 40,12,240

        1111111111111111111111111
        1000000000110000000000001
        1011000001110000000000001
        1001000000000000000000001
111111111011000001110000000000001
100000000011000001110111111111111
1111011111111011100000010001
1111011111111011101010010001
111111111111111111111111111
1100000011111011100000010001
1000000000000001100000010001
1000S000000000001101010010001
110000011101010111110111100011
11110111 1110101 101111010001
11111111 1111111 111111111111
