NO ./textures/eagle.xpm    
SO ./textures/eagle.xpm
WE ./textures/eagle.xpm   
EA ./textures/eagle.xpm

F 127, 0, 0
C 135, 50


1111111111111111111111111111
1E00000100100110000000000001
1111111111111111111111111111
